; Lines are 12-3
; # = wall, @ = playerStartPosition, * = special, - = null
##########################
#--*-----------##-----@--#
#######---##--*----------#
#---------##-------------#
##-----*-*------##-###-*-#
#---------###---##------##
##########################